ldt=Caliper - Lithodensity Tool
usgscali=USGS Caliper
obhtv=USGS Optical Borehole Televiewer
gr=Natural Gamma Ray Tool
ngt=Natural Gamma Ray Spectrometry Tool
act=Aluminum Clay Tool
gst=Induced Gamma Ray Spectrometry Tool
misc=Miscellaneous Measurements
cntg=Compensated Neutron Tool
dll=Dual Laterolog
mft=USGS Multi Function Tool
sscanner=Sonic Waveforms Image 
abhtv=USGS Acoustic Borehole Televiewer
ppc=Caliper - Power Positioning Device and Caliper Tool
emfm=USGS Electromagnetic Flowmeter
hpfm=USGS Heat Pulse Flowmeter
edtc=Enhanced Digital Telemetry Cartridge
devi=USGS Deviation Tool
gpit=Field Print - General Purpose Inclinometer Tool
usgssusc=USGS Magnetic Susceptibility Tool
cmr=Combinable Magnetic Resonance Tool
aps=Accelerator Porosity Sonde
ait=Array Induction Imager Tool
sp=Spontaneous Potential Spontaneous Potential Log
tld=Caliper - Three Detector Density Tool
fmi=Field Print - Fullbore Formation MicroImager
cbl=Field Print - Casing Bond Log
mdt=Field Print - Modular Formation Dynamic Tester
msct=Field Print - Mechanical Sidewall Coring Tool
hgns=Gamma Ray - Highly Integrated Gamma Ray Neutron Sonde
hngs=Field Print - Hostile Environment Gamma Ray Sonde
ecs=Elemental Yields - Elemental Capture Spectroscopy Sonde
ildt=Caliper - iFlex Litho Density Tool
itgn=iFlex Telemetry Gamma
mss=Magnetic Susceptibility Sonde
idfr=iFlex Induction Dual Formation Resistivity Tool
islt=iFlex Sonic Logging Tool
