#Note: These are just the survey commodities
AG LAND=AG LAND
AG SERVICES=AG SERVICES
AG SERVICES & RENT=AG SERVICES & RENT
ALCOHOL COPRODUCTS=ALCOHOL COPRODUCTS
ALMONDS=ALMONDS
ANIMAL SECTOR=ANIMAL SECTOR
ANIMAL TOTALS=ANIMAL TOTALS
APPLES=APPLES
APRICOTS=APRICOTS
ARTICHOKES=ARTICHOKES
ASPARAGUS=ASPARAGUS
AUTOS=AUTOS
AVOCADOS=AVOCADOS
BANANAS=BANANAS
BARLEY=BARLEY
BEANS=BEANS
BEDDING PLANTS, ANNUAL=BEDDING PLANTS, ANNUAL
BEDDING PLANTS, HERBACEOUS PERENNIAL=BEDDING PLANTS, HERBACEOUS PERENNIAL
BEEF=BEEF
BEESWAX=BEESWAX
BEETS=BEETS
BISON=BISON
BLACKBERRIES=BLACKBERRIES
BLUEBERRIES=BLUEBERRIES
BOYSENBERRIES=BOYSENBERRIES
BROCCOLI=BROCCOLI
BRUSSELS SPROUTS=BRUSSELS SPROUTS
BUILDING MATERIALS=BUILDING MATERIALS
BUTTER=BUTTER
BUTTERMILK=BUTTERMILK
CABBAGE=CABBAGE
CAMELINA=CAMELINA
CANEBERRIES=CANEBERRIES
CANOLA=CANOLA
CARROTS=CARROTS
CATTLE=CATTLE
CAULIFLOWER=CAULIFLOWER
CELERY=CELERY
CHEESE=CHEESE
CHEMICAL TOTALS=CHEMICAL TOTALS
CHEMICALS, OTHER=CHEMICALS, OTHER
CHERRIES=CHERRIES
CHICKENS=CHICKENS
CITRUS TOTALS=CITRUS TOTALS
COFFEE=COFFEE
COMMODITY TOTALS=COMMODITY TOTALS
CONSUMER PRICE INDEX=CONSUMER PRICE INDEX
CORN=CORN
COTTON=COTTON
CRANBERRIES=CRANBERRIES
CREAM=CREAM
CROP SECTOR=CROP SECTOR
CROP TOTALS=CROP TOTALS
CROPS, OTHER=CROPS, OTHER
CRUDE PINE GUM=CRUDE PINE GUM
CUCUMBERS=CUCUMBERS
CUT CHRISTMAS TREES=CUT CHRISTMAS TREES
CUT CULTIVATED GREENS=CUT CULTIVATED GREENS
CUT FLOWERS=CUT FLOWERS
DAIRY PRODUCT TOTALS=DAIRY PRODUCT TOTALS
DAIRY PRODUCTS, OTHER=DAIRY PRODUCTS, OTHER
DATES=DATES
DECIDUOUS FLOWERING TREES=DECIDUOUS FLOWERING TREES
DECIDUOUS SHADE TREES=DECIDUOUS SHADE TREES
DECIDUOUS SHRUBS=DECIDUOUS SHRUBS
DUCKS=DUCKS
EGGPLANT=EGGPLANT
EGGS=EGGS
EQUINE=EQUINE
ESCAROLE & ENDIVE=ESCAROLE & ENDIVE
EVERGREENS, BROADLEAF=EVERGREENS, BROADLEAF
EVERGREENS, CONIFEROUS=EVERGREENS, CONIFEROUS
EXPENSE TOTALS=EXPENSE TOTALS
EXPENSES, OTHER=EXPENSES, OTHER
FACILITIES & EQUIPMENT=FACILITIES & EQUIPMENT
FARM OPERATIONS=FARM OPERATIONS
FARM SECTOR=FARM SECTOR
FEED=FEED
FEED GRAINS=FEED GRAINS
FEED GRAINS & HAY=FEED GRAINS & HAY
FEED PRICE RATIO=FEED PRICE RATIO
FERTILIZER TOTALS=FERTILIZER TOTALS
FERTILIZER, MIXED=FERTILIZER, MIXED
FERTILIZER, OTHER=FERTILIZER, OTHER
FIELD CROP TOTALS=FIELD CROP TOTALS
FIELD CROPS, OTHER=FIELD CROPS, OTHER
FIELDWORK=FIELDWORK
FIGS=FIGS
FLAXSEED=FLAXSEED
FLORICULTURE TOTALS=FLORICULTURE TOTALS
FLOWERING PLANTS, POTTED=FLOWERING PLANTS, POTTED
FOLIAGE PLANTS=FOLIAGE PLANTS
FOOD COMMODITIES=FOOD COMMODITIES
FOOD GRAINS=FOOD GRAINS
FRUIT & NUT PLANTS=FRUIT & NUT PLANTS
FRUIT & TREE NUT TOTALS=FRUIT & TREE NUT TOTALS
FUELS=FUELS
FUMIGANTS=FUMIGANTS
FUNGICIDES=FUNGICIDES
FUNGICIDES & OTHER=FUNGICIDES & OTHER
GARLIC=GARLIC
GINGER ROOT=GINGER ROOT
GOATS=GOATS
GOOSEBERRIES=GOOSEBERRIES
GRAIN=GRAIN
GRAIN STORAGE CAPACITY=GRAIN STORAGE CAPACITY
GRAPEFRUIT=GRAPEFRUIT
GRAPES=GRAPES
GRASSES=GRASSES
GRASSES & LEGUMES TOTALS=GRASSES & LEGUMES TOTALS
GREENS=GREENS
GUAVAS=GUAVAS
HAY=HAY
HAY & HAYLAGE=HAY & HAYLAGE
HAYLAGE=HAYLAGE
HAZELNUTS=HAZELNUTS
HERBICIDES=HERBICIDES
HOGS=HOGS
HONEY=HONEY
HOPS=HOPS
ICE CREAM=ICE CREAM
IMPROVEMENT & CONSTRUCTION=IMPROVEMENT & CONSTRUCTION
INSECTICIDES=INSECTICIDES
INTEREST=INTEREST
K-EARLY CITRUS=K-EARLY CITRUS
KIWIFRUIT=KIWIFRUIT
LABOR=LABOR
LAMB & MUTTON=LAMB & MUTTON
LEGUMES=LEGUMES
LEMONS=LEMONS
LENTILS=LENTILS
LETTUCE=LETTUCE
LIMES=LIMES
LIVESTOCK TOTALS=LIVESTOCK TOTALS
LOGANBERRIES=LOGANBERRIES
MACADAMIAS=MACADAMIAS
MACHINERY TOTALS=MACHINERY TOTALS
MACHINERY, OTHER=MACHINERY, OTHER
MAPLE SYRUP=MAPLE SYRUP
MELLORINE=MELLORINE
MELONS=MELONS
MILK=MILK
MILLET=MILLET
MINT=MINT
MOHAIR=MOHAIR
MUSHROOMS=MUSHROOMS
MUSTARD=MUSTARD
NECTARINES=NECTARINES
NITROGEN=NITROGEN
NON-CITRUS FRUIT & TREE NUTS TOTALS=NON-CITRUS FRUIT & TREE NUTS TOTALS
NON-CITRUS TOTALS=NON-CITRUS TOTALS
NONFARM SECTOR=NONFARM SECTOR
NURSERY & FLORICULTURE TOTALS=NURSERY & FLORICULTURE TOTALS
NURSERY TOTALS=NURSERY TOTALS
OATS=OATS
OIL=OIL
OIL-BEARING CROPS=OIL-BEARING CROPS
OKRA=OKRA
OLIVES=OLIVES
ONIONS=ONIONS
ORANGES=ORANGES
ORNAMENTAL GRASSES=ORNAMENTAL GRASSES
PALMS=PALMS
PAPAYAS=PAPAYAS
PASTURELAND=PASTURELAND
PEACHES=PEACHES
PEANUTS=PEANUTS
PEARS=PEARS
PEAS=PEAS
PEAS & CARROTS=PEAS & CARROTS
PECANS=PECANS
PEPPERS=PEPPERS
PHOSPHATE=PHOSPHATE
PICKLES=PICKLES
PINEAPPLES=PINEAPPLES
PISTACHIOS=PISTACHIOS
PITW=PITW
PLUMS=PLUMS
PLUMS & PRUNES=PLUMS & PRUNES
POPCORN=POPCORN
PORK=PORK
POTASH=POTASH
POTASH & PHOSPHATE=POTASH & PHOSPHATE
POTATOES=POTATOES
POTATOES & DRY BEANS=POTATOES & DRY BEANS
POULTRY TOTALS=POULTRY TOTALS
POULTRY, OTHER=POULTRY, OTHER
PPITW=PPITW
PRICE INDEX RATIO=PRICE INDEX RATIO
PRODUCTION ITEMS=PRODUCTION ITEMS
PROPAGATIVE MATERIAL=PROPAGATIVE MATERIAL
PRUNES=PRUNES
PUMPKINS=PUMPKINS
RADISHES=RADISHES
RAPESEED=RAPESEED
RASPBERRIES=RASPBERRIES
RED MEAT=RED MEAT
RENT=RENT
REPAIRS=REPAIRS
RICE=RICE
ROW CROPS=ROW CROPS
RYE=RYE
SAFFLOWER=SAFFLOWER
SEEDS & PLANTS TOTALS=SEEDS & PLANTS TOTALS
SELF PROPELLED=SELF PROPELLED
SHEEP=SHEEP
SHERBET=SHERBET
SMALL GRAINS=SMALL GRAINS
SNOW=SNOW
SOIL=SOIL
SORGHUM=SORGHUM
SOYBEANS=SOYBEANS
SPINACH=SPINACH
SQUASH=SQUASH
STRAWBERRIES=STRAWBERRIES
SUGARBEETS=SUGARBEETS
SUGARCANE=SUGARCANE
SUNFLOWER=SUNFLOWER
SUPPLIES=SUPPLIES
SUPPLIES & REPAIRS=SUPPLIES & REPAIRS
SWEET CORN=SWEET CORN
SWEET POTATOES=SWEET POTATOES
TANGELOS=TANGELOS
TANGERINES=TANGERINES
TARO=TARO
TAXES=TAXES
TEMPLES=TEMPLES
TOBACCO=TOBACCO
TOMATOES=TOMATOES
TRACTORS=TRACTORS
TRACTORS & SELF PROPELLED=TRACTORS & SELF PROPELLED
TRANSPLANTS=TRANSPLANTS
TREE NUT TOTALS=TREE NUT TOTALS
TRUCKS=TRUCKS
TRUCKS & AUTOS=TRUCKS & AUTOS
TURKEYS=TURKEYS
VEAL=VEAL
VEGETABLE TOTALS=VEGETABLE TOTALS
VEGETABLES, MIXED=VEGETABLES, MIXED
VEGETABLES, OTHER=VEGETABLES, OTHER
WALNUTS=WALNUTS
WATER=WATER
WATER ICES=WATER ICES
WHEAT=WHEAT
WHEY=WHEY
WOODY ORNAMENTALS & VINES, OTHER=WOODY ORNAMENTALS & VINES, OTHER
WOOL=WOOL
YOGURT=YOGURT

